Alegan – Ángela 
Riesgo – Sergio
Valora – Álvaro 
Agonista – Santiago
Colinas – Nicolás 
Calor – Carla
Quieren – Enrique 
Prisa – París
Riesgo – Sergio 
Poder – Pedro
Ramón – Norma 
Necrófila – Florencia
Poder – Pedro 
Armonía – Mariano
Mora – Roma 
Salario – Rosalía
Saunas – Susana 
Ovoide – Oviedo
Aretes – Teresa 
Camelia – Micaela
Ventilan – Valentín 
Enlodar – Leandro
Trama – Marta 
Delira – lidera
Cardiografía – radiografía 
Agranda – granada
Desamparador – desparramado 
Licúa – Lucía
Conservadora – conversadora 
Amor – Roma
Irónicamente – renacimiento 
Nacionalista – altisonancia
Escandalizar – zascandilear 
Frase – fresa
Enfriamiento – refinamiento 
Integrarla – Inglaterra
Sórdidamente – desmentidora 
Acuerdo – Ecuador
Materialismo – memorialista 
Deudora – Eduardo
Energéticamente – genéricamente 
Fotoligografía – litofotografía
Presuposición – superposición 
Saco – cosa
Enamoramientos – armoniosamente 
Caldearnos – encaradlos
Rectificable – certificable 
Aceleradnos – acerándoles
Reconquistados – conquistadores 
Acertándoles – altercándose
Escabullimiento – bulliciosamente 
Caliente – Alicante
Electromagnético – magnetoeléctrico 
Posaré – posera
Imponderablemente – imperdonablemente 
Topera – trepaos
Armonización – romanización 
Sopera – sopear
Pronosticación – contraposición 
Áspero – espora
Nepal – panel 
Aires – Aries
Raza – Zara 
Presa – rapés
Pagar – Praga 
Esta – ates
Cornisa – Narciso 
Él – le
Amparo – Páramo 
Resto – retos
Camino – Mónica 
Reías – ríase
Matar – Marta 
Terso – teros
Anagrama – amar, gana
Anagramas – a ganar más
La contravino – No la vi entrar
El huevo de chocolate – hecho de vate locuelo
Istmo de Panamá – Tío San me da pan
La revolución francesa – un corso clave la fresa
Alborota – rata, lobo

